***********.*
*S.....**.*.T
*****.....*.*
*****.***.*.*
*****.*****.*
*****.*****.*
*****.......*
*****.*******
*.........***
*.******...**
*....********
